111111111111111111
1P00000C0000010001
101111011100111001
110010000000010001
100C00110001111101
1001111110111000E1
1000000C0011000001
101111001110111101
110000000010100001
100000000C00100101
101110111000100001
111111111111111111
