1111111111111111111
1P00000000C000C0011
1000011011000011001
1000010001000000001
1C00011001000001111
111011111000001C001
10000C0000001111E01
1000110000000010001
1000001001111000001
1111111111111111111
