11111111111111111
1P00000000C000001
1C001100000110011
10100001110000001
11001000000C01101
111001110000000C1
1C000010011100001
10011110001110001
1000000000C001001
1100E000100010001
10111110000111001
11111111111111111
