1111111111111111
1P000000C0000001
1011111111101001
1C0C1000CC01C001
1101110000101111
10000C1000100E01
1001110001000001
1010001011000011
1C0000CC1000C001
1101110001100101
1C0000C0000C0001
100C001000C11C01
1111111111111111
