111111111111111111
1P0000000000C00001
101100001111101001
11000C000000001001
111111110011100101
100100000000000111
10C111000011110E01
11000C000100000001
111110111011100001
1C0010000000000011
100001100011110001
1C0001000C00010001
1000000011000010C1
111111111111111111
