11111111111111111
100000C0000E11111
11C11110101111011
10001P001C0000001
1C101100000010001
10101101101111011
110000C00011110C1
11111111111111111
