11111111111111111
10000111111000E11
1C11011C000010111
1010011C010110001
101C0010010010101
100010011000101C1
111P110110100C111
1110000C00110C111
11111111111111111
