11111111111111111111111
1E0000000010C1000000001
1001011010000101111C001
1001000010110001C1000C1
1P000110010000010001001
1001101C1C11000101000C1
11111111111111111111111
