11111111111111111111111
10C00000000000000000001
10000000001001111000001
10110C00011000001001101
10C100001010000C1001C01
10010001001001111001001
10C10011111101000001001
10110000001001C00001101
100000P000100111100C001
100000001001C0E000000C1
11111111111111111111111
