1111111
1C0C1E1
10P0101
1111111
