111111111111111
1P000000C000001
100111111101001
110000010000C01
100C01001111111
111001000000E01
100C01000011101
100011110010001
1C0000010000011
1C0101110001111
100001000C00001
1C0001000000001
111111111111111
