111111111111111
1P0000C00100001
111000111110001
1000001000000E1
1000C0110000011
110000001000001
100111101100001
1000100000100C1
100010000100001
111111111111111
