11111111111111111
1P00000C000001001
10111101110011101
11001000000000001
100C0011000111111
100111111011100E1
1000000C001100001
10111100111011111
11000000001000001
100000000C0010011
101110111000100C1
11111111111111111
