1111111111111111
1P00001000C00001
1110111100111001
1100000001001001
100C011100011101
100001000C100001
1110011111010001
1001000010000001
1011111000011001
1C001000001C00E1
1000001000000001
1111111111111111
