11111111111111111111111
11000000000000C00011111
11011111111111111111111
1100000P111111110011111
11110111111111000111111
11110111111111011110011
11110000000000011110001
11111111111111111111111