111111111111111111111111111111111111111111
110000E0000000C0001111111000000000000C0001
110000000000000000000000000000000000000001
110000001111111100111111100000011111111001
111101111111110001111111111011111111100011
111101111111110111100111111011111111101111
111100000000000111100011111000000000001111
111111111111111111111111111111111111111111
