11111111111111111111111
11000000E00000C00011111
11011111111111111111111
110E000P111111110011111
11110111111111000111111
11110111111111011110011
111100E0000000011110001
11111111111111111111111