11111111111111111111111
110000E0000000C00011111
11011111111111111111111
1100000P111111110011111
11110111111111000111111
11110111111111011110011
111100000000P0011110001
11111111111111111111111