111111111
1C0000011
10PE00001
110C000C1
1C000A0C1
111111111